111111111111111111111111111111111111
10P0000C0000010000000000000000000001
100000000000010000000000010000000001
100C000000000100000000001E1000000001
100000000000110000000000010000000001
100000000000000000000000000000000001
111111111111111111011111111111111111
100000000000000000000000000000000001
1000000000000000000000C0000000000001
111111111111111111111111111111111111