111111111111111111111111111111111111
1000000C00000100000P0000000000000001
100000000000010000000000000000000001
100C0000000001000000000001000E000001
100000000000110000000000101000000001
100000000000000000000000010000000001
100000000000100000100000000000000001
111111111111111101111111111111111111
100000000001000000000000000000000001
1000000000000000000000C0000000000001
111111111111111111111111111111111111