1111111111
1P00000E01
1000001111
1C00010111
1111111111