111111111111111111
10000000000C000111
110000000000000001
1P0E00000C11111111
111111111111111111