111111111111111111
100P0000000C000111
100000000000000001
100000000C11111111
111111111111111111