11111111111111111
1000C000010000001
11100000EC0000001
11000000011100011
11111111111111111